R 600 450
NO ./texture/1.xpm
SO ./texture/3.xpm
WE ./texture/4.xpm
EA ./texture/5.xpm
S ./texture/2.xpm
F 0,0,0
C 255,255,255

        1111111111111111111111111
        1000000000000000000022201
        1011000002220000002020201
        100000000S000000000020001
111111111011000001110000000000001
100000000011000001110111111111111
1111111111111111111111
                             

                11111111111111111111111111111
                11110111111111011100000010001
                11110111111111011101010010001
                11000000110101011100000010001
                10002000000000001100000010001
                10000000000000001101010010001
                1100000111010101111101111000111
                11110111 1110101 101111010001
                11111111 1111111 111111111111